NO textures/north_wall.xpm
SO textures/south_wall.xpm
EA textures/east_wall.xpm
WE textures/west_wall.xpm

F 220,100,0
C 225,30,0

            1111          1111111
           100001      111 01
          10000001    10000001111
           1000001   1 000E000001
111      11 000001    10000000001
101     1   10000 1111      01111
1 1      1 1 10   000000 0001
1 11      1  10    0 0 00 0001
1 001         1   000000 0001
1000 111111111000  000000 0001
10000    000000  0 0 00 000   11111111
1 00000   0 0 0     0       00000000 1
11110      1   1   1        1111111111
    1111111 1111111 11111111
